W W W W W W W W W W W W W W W W W W W
W S S S W S S S S S S S S S W S S B W
W B S S W S S W W W W W W S W S S S W
W S W W W S S S S S S S S S W W W S W
W S W S S S S W S S S W S S S S W S W
W S W S W W S W 1 S 2 W S W W S W S W
W S W S S S S W W W W W S S S S W S W
W S S S W W S S S S S S S W W S S S W
W W W S S S S W W W W W S S S S W W W
S S S S S E E E E E E E E E S S S S S
W W W S S W S W W W W W S W S S W W W
W S S S S W S S S S S S S W S S E E W
W S W S S W S W W W W W S W S S W S W
W S W S S S S S S W S S S S S S W S W
W S W S S W W W W W W W W W S S W B W
W S W S S S S S S P S S S S S S W S W
W B W W S S S W W W W W S S S W W S W
W S S S S S S S S W S S S S B S S S W
W S W W W S S W W W W W S S W W W S W
W S S S W S S S S S S S S S W S S S W
W W W W W W W W W W W W W W W W W W W